6 24 20 2 80
0 1 2 3 4 3 5 6 1 1 1 1 7 7 1 7 1 1 7 1 7 1 8 9 
0 10 3 2 3 3 5 11 10 8 12 10 4 8 12 6 10 8 12 4 8 12 13 9 
0 3 3 3 2 4 5 10 4 14 15 4 10 16 17 11 3 16 18 10 14 15 10 9 
0 4 3 1 1 1 5 13 10 13 17 10 4 19 0 10 3 19 19 4 14 0 3 21 
0 1 3 4 3 10 5 10 4 1 10 3 3 1 10 4 3 10 10 10 10 3 3 22 
0 3 1 1 23 23 24 23 23 23 23 23 23 23 23 23 23 23 23 23 23 0 0 0