1,1,2,3,1,2,4,1,2,5,6,7,1,8,2,7,1,8,2,7,1,9,4,10,0
1,3,14,1,1,14,15,1,14,17,3,1,2,8,14,7,2,8,14,7,2,21,15,10,0
36,37,37,38,41,14,15,1,14,29,1,1,14,1,14,1,14,1,14,4,14,33,15,22,0
5,1,14,39,40,37,36,37,37,38,41,1,14,1,14,1,14,1,14,3,14,45,46,34,0
29,1,14,1,4,14,3,14,3,39,42,41,14,1,14,1,14,1,14,1,14,44,47,10,0
24,24,25,24,24,25,24,25,24,24,24,40,25,24,25,24,25,24,25,24,25,24,24,26,0
