0,1,1,1,1,1,0,0,0,1,1,1,1,1,0,0,0,0,0,0,2,3,3,5
6,6,6,6,6,6,1,1,6,6,6,6,6,6,1,1,1,1,1,1,8,4,4,11
6,7,6,6,6,6,6,6,6,7,6,6,6,6,6,6,6,6,7,7,14,15,4,5
7,12,7,7,7,7,7,7,7,13,7,7,7,7,7,7,7,7,12,13,14,5,4,11
19,18,22,19,19,22,19,22,19,22,22,19,19,22,19,22,22,23,18,21,16,20,10,11
13,13,13,13,13,13,13,13,13,13,13,13,13,13,13,13,13,13,13,13,13,13,13,13
