0,10,3,3,10,30,30,30,30,30,30,30,30,30,30,30,30,30,30,30,30,30,30,0
0,3,3,4,3,30,30,30,29,29,30,30,30,30,13,30,30,30,30,30,15,29,29,0
0,3,3,10,3,30,30,13,8,12,13,30,30,30,27,29,29,29,29,17,0,4,3,21
0,3,4,27,0,30,12,7,28,30,3,13,13,29,6,23,3,1,2,10,4,3,23,22
0,3,27,3,3,17,17,4,10,10,3,3,27,1,10,13,3,8,12,2,3,23,10,0
0,0,26,4,4,7,1,1,1,7,13,1,3,28,1,23,23,28,13,1,1,3,3,0
