7 8 10 2 20 80
0 1 2 2 3 4 1 13 
0 1 2 3 2 5 1 13 
13 6 7 8 9 2 1 13 
13 1 5 2 2 10 6 13 
11 1 2 2 3 2 4 13 
12 6 8 7 9 9 8 13 
13 13 13 13 13 13 13 13