0,13,5,1,2,5,13,2,1,2,13,1,2,2,13,15
11,5,2,1,4,13,2,2,1,13,2,1,4,13,2,15
12,2,13,6,14,2,9,9,6,5,2,6,14,9,2,15
0,2,14,1,15,2,2,15,0,9,4,15,5,4,10,15
0,13,5,1,15,2,13,15,0,2,14,15,2,3,1,15
0,4,2,1,15,2,2,15,0,2,2,2,3,2,1,15
